 # # # # # # # # # # # # # # # # # # # # # # #
# # # # # # . . . . . . . . . . . # # # # # #
 # # # # # . . . . . . . . . . . . # # # # # #
# # # # # . . . . . . . . . . . . . # # # # #
 # # # # . . . . . . . . . . . . . . # # # # #
# # # # . . . . . . . . . . . . . . . # # # #
 # # # . . . . . . . . . . . . . . . . # # # #
# # # . . . . . . . . . . . . . . . . . # # #
 # # . . . . . . . . . . . . . . . . . . # # #
# # . . . . . . . . . . . . . . . . . . . # #
 # . . . . . . . . . # # # # . . . . . . . # #
# . . . . . . . . . # . . . # . . . . . . . #
 # . . . . . . . . # . . . . # . . . . . . # #
# # . . . . . . . # . . . . . # . . . . . # #
 # # . . . . . . . # . . . . # . . . . . # # #
# # # . . . . . . . # . . . # . . . . . # # #
 # # # . . . . . . . # + # # . . . . . # # # #
# # # # . . . . . . . . . . . . . . . # # # #
 # # # # . . . . . . . . . . . . . . # # # # #
# # # # # . . . . . . . . . . . . . # # # # #
 # # # # # . . . . . . . . . . . . # # # # # #
# # # # # # . . . . . . . . . . . # # # # # #
 # # # # # # # # # # # # # # # # # # # # # # #
